Gll^Es, Gd^Em, Gd^Emf, Hhd^Fmw, Sm, Ss, Sm, Wwf^Es, Wwg^Dr, Wwf, Ss, Ss, Sm, Ss, Hhd^Fp, Ss, Hhd^Fdw, Gll^Fp, Gll^Es, Gll^Fp, Gll^Fp, Hhd^Fp, Hhd, Ss^Qhu, Ss^Qhu, Ss^Qhu, Ss^Qhu, Ss^Qhu, Mm^Qhu, Mm^Xm, Mm^Xm, Mm^Xm, Mm, Mm, Mm, Mm, Mm^Qhh, Mm^Xm, Mm, Mm
Hhd^Fdw, Gll^Emf, Gd^Fp, Ss, Sm, Sm, Chs^Fmw, Chs^Em, Chs^Emf, Hhd^Fetd, Ss, Sm, Sm, Hhd^Fdw, Hhd^Fmw, Hhd^Fmw, Gll^Fdw, Gd^Emf, Gd^Emf, Gd^Em, Gll^Fp, Hhd, Hhd^Em, Ss^Qhu, Ss^Qhu, Ss^Qhu, Ss^Qhu, Ss^Qhu, Ss^Qhu, Mm^Qhu, Mm, Mm, Mm^Xm, Mm^Xm, Hh^Dr, Hh^Qhh, Gg^Efm, Mm, Hh^Fds, Hh^Fds
Hhd, Hhd^Fmw, Ss, Ss, Ss, Sm^Ewl, Sm^Ewl, 3 Khs^Fdw, Ds, Hhd^Vhcr, Wwf^Wkf, Ss, Gll^Fmw, Sm, Hhd^Fp, Gll^Fp, Gd^Es, Gd^Emf, Gd^Em, Gll, Gll^Emf, Gll^Fp, Hhd, Hhd, Ss^Qhu, Ss^Qhu, Ss^Qhu, Sm^Qhu, Mm^Qhu, Mm^Qhu, Mm^Xm, Mm, Mm^Qhh, Mm^Xm, Hh^Qhh, Gg^Efm, Gs^Efm, Hh^Em, Hh^Fds, Hh^Fds
Sm, Sm, Ss, Ss, Wwf^Wkf, Wwf^Wkf, Wwf^Es, Wwf^Es, Wwf, Wwg^Bw/r, Wwf^Bw/r, Gll^Fdw, Gd^Fdw, Ss, Ss, Gll, Gll^Fdw, Gd^Fmw, Gd^Emf, Gll^Em, Gd^Emf, Gll, Gll^Fp, Hhd^Fp, Hhd^Fp, Sm^Qhu, Sm^Ewl, Sm^Qhu, Mm^Qhu, Mm^Xm, Mm^Xm, Mm, Mm^Qhh, Mm^Qhh, Hh^Fds, Gg^Fds, Gs^_mh, Gs^Fet, Hh^Fds, Hh^Fds
Ss, Sm, Sm^Ewl, Ss, Wog, Wwg^Wkf, Wwf, Wwf^Es, Ww^Vm, Wwg^Ewl, Wwg, Rb^Emf, Rb^Em, Ss, Hhd^Fmw, Ss, Gll, Gll^Es, Gd^Em, Gd, Gd^Fp, Gd^Es, Gd^Fp, Hhd^Fp, Gll^Fp, Sm^Qhu, Sm^Ewl, Sm^Ewl, Mm^Qhu, Mm^Qhu, Mm^Xm, Mm^Xm, Hh^Fds, Hh^Fds, Mm^Qhh, Mm^Qhh, Mm^Qhh, Mm^Qhh, Mm^Qhh, Mm^Qhh
Sm, Sm, Wwf^Ewl, Wog^Ewf, Wog, Wwf, Ds^Es, Wwf, Wwrg, Wwg, Sm, Sm, Rb, Hhd, Hhd^Fmw, Hhd^Fmw, Gll^Em, Gll^Efm, Gll^Efm, Gll^Fp, Gd^Fp, Gd^Es, Gd^Em, Gll^Fp, Gll, Ss^Qhu, Wwf^Wkf, Wwf^Wkf, Sm^Qhu, Mm^Qhu, Mm^Xm, Mm^Qhh, Hh^Fds, Hh^Fds, Gs^Fds, Mm^Qhh, Mm^Qhh, Mm^Xm, Mm^Xm, Mm^Xm
Sm, Wwf^Es, Wwf, Wwg, Ds, Wwg, Wwf, Wwf^Es, Wwrg, Wwrg, Gll^Fdw, Ss, Rb^Em, Gd^Es, Rb^Es, Gll^Fp, Rb^Es, Gll, Gll^Fp, Gll^Fp, Gll^Fp, Gll, Gd^Es, Gd^Es, Sm^Qhu, Sm^Qhu, Wwf^_ml, Wwf^Wkf, Sm^Wkf, Sm^Qhu, Mm^Qhu, Mm^Qhh, Mm^Qhh, Hh^Qhh, Gs^Es, Gs^Fms, Mm^Qhh, Mm^Xm, Mm, Mm^Xm
Ss, Ss, Ss, Ds, Gll^Feth, Ds^Es, Wwf^Wkf, Wwf, Wwf, Wwf^Wkf, Wwf^Wkf, Gll^Emf, Gd^Emf, Rb^Emf, Hhd^Fetd, Rb, Hhd, Rb, Gd, Gd^Fp, Gll, Gll^Efm, Gd^Efm, Gd^Es, Gll, Wwf^Qhu, Wwg^Qhu, Wwf^Es, Wwf^Wkf, Wwf^Dr, Mm^Qhu, Mm^Qhh, Mm^Qhh, Hh^Fms, Mm^Qhh, Gg^Fms, Mm^Qhh, Mm, Mm^Xm, Mm
Gll^Emf, Gd^Emf, Gll^Fmw, Gd^Em, Gd^Efm, Wwf^Wkf, Ds, Ds, Ds^Es, Ds, Wwf^Wkf, Gd^Fdw, Gll^Fdw, Gd^Fdw, Hhd^Fdw, Hhd^Vc, Hhd^Em, Rb, Rb, Gd, Hhd, Hhd, Hhd^Fms, Hhd^Fp, Wwrg^Qhu, Wwg^Qhu, Wwg^Qhu, Wwf^Wkf, Mm^Qhu, Mm^Qhu, Mm^Xm, Mm^Xm, Mm^Xm, Mm^Qhh, Gs^Qhh, Gg^Qhh, Mm^Qhh, Mm, Mm^Xm, Mm^Xm
Gll^Fmw, Gll^Emf, Gll^Fp, Gd^Fdw, Gd, Gd, Gll^Es, Rb, Gll, Ds, Gll, Gll^Fmw, Gll^Es, Hhd^Fdw, Hhd, Hhd^Em, Hhd, Gll^Fp, Rb, Gd^Efm, Hhd, Hhd^Fet, Gd^Efm, Hhd^Fp, Wog^Qhu, Wog^Qhux, Wog^Qhu, Mm^Qhu, Mm, Mm, Hh, Mm^Xm, Gg^Es, Hh, Hh, Hh^Em, Hh^Qhh, Hh^Qhh, Mm^Qhh, Mm
Hhd^Fp, Hhd^Fp, Gll^Emf, Gll^Fp, Gd^Em, Gll^Fp, Rb, Rb, Gll^Es, Gll^Es, Hhd, Gd, Gll, Hhd, Gll, Gd^Efm, Gd^Efm, Gll^Efm, Gll, Rb, Rb^Es, Rb, Re, Hhd^Fds, Re, Wwf, Gs^Es, Gs, Gg^Efm, Hh, Hh^Em, Gg, Gg^Fds, Gs, Gd, Gd^Es, Hh^Qhh, Hh^Qhh, Mm^Qhh, Mm^Qhh
Hhd^Fp, Hhd^Fp, Hhd^Em, Gd^Vhr, Gll^Fp, Gd^Em, Re, Gd, Gll^Fp, Hhd, Hhd^Fp, Hhd, Gd^Es, Gd, Gs, Gd^Efm, Gs, Gd, Re^Es, Re, Wwf^Wkf, Wwf^Wkf, Gs, Re, Hh^Fds, Wwf^Bw/r, Hh^Em, Gs^Efm, Gg^Fet, Re, Re^Es, Re^Es, Re, Gs^Es, Gs, Hh^Fp, Hh^Fms, Hh^Qhh, Hh^Qhh, Mm^Qhh
Wwg, Wwrg, Ds, Hhd^Fms, Hhd^Fds, Re, Gs, Gs^Fms, Gd^Vhr, Gll^Fp, Gs^Fms, Gd, Gd, Gd, Gs^Fds, Gs^Fds, Gg^Efm, Gd, Re, Mm, Mm, Wwf^Wkf, Ds^Es, Gs^Fds, Wwrg, Wwg, Cfr^Eb, Hh^Fds, Hh, Gd^Efm, Gd^Vhhr, Gs^Es, Hh, Hh, Hh^Dr, Hh^Fms, Hh^Qhh, Hh^Qhh, Mm^Qhh, Mm^Qhh
Wwg, Wwrg, Ds^Ewsh, Ds, Gs, Re, Gs^Em, Gs^Fms, Gll^Fp, Hh, Gs^Fms, Gs^Fds, Gd, Gd^Efm, Gs, Mm, Gg^Fds, Gg^Efm, Mm, Mm, Ds, Ds, Ds, Ds, Wog, Wog, Wwg, Hh, Mm, Gll^Fp, Mm, Mm, Hh^Qhh, Hh^Qhh, Gg^Qhh, Gs^Qhh, Hh^Fms, Hh^Qhh, Mm^Qhh, Mm^Qhh
Wwg, Wwrg, Wwrg, Ds, Ds, Gd^Edb, Gd^Vhr, Gll^Fp, Hh, Hh^Em, Hh^Em, Gs^Fds, Gs^Efm, Gs, Gs^Fds, Gs^Fet, Gll^Emf, Gd^Ve, Gs^Em, Ds, Ds, Wwrg, Wwrg, Wwg, Wog, Wog^Ewf, Wwg^Ewf, Wog, Mm, Mm, Mm, Mm^Qhh, Gs^Efm, Hh^Qhh, Gg^Es, Gg^Fds, Gg^Fds, Mm^Qhh, Hh^Dr, Mm^Qhh
Wwrg, Wwrg, Ds^Edb, Ds^Edb, Ds, Gd^Edb, Gd^Edb, Gd^Es, Hh^Fds, Hh^Fds, Hh^Fds, Gg^Efm, Gs^Efm, Gs^Fms, Gg^Fms, Gs^Fms, Gll^Fp, Gd^Emf, Ds, Ds^Es, Wwf^Es, Wwrg, Ds, Wwg, Wwrg, Wwg^Ewl, Hh, Hh^Fds, Mm^Xm, Mm^Xm, Mm^Qhh, Mm^Qhh, Gs, Gs, 2 Kfr, Gs^_mh, Gs^Efm, Gs^Es, Hh^Qhh, Mm^Qhh
Wwg, Wwrg, Ds, Ds, Ds, Ds, Ds, Gd, Hh, Mm, Hh, Gg, Gg, Mm, Hh^Vhh, Gs^Fds, Mm, Hh^Fp, Wog, Ds^Es, Wwf, Wwf, Ds, Hh, Mm, Wwrg, Mm, Hh, Mm^Xm, Mm^Xm, Mm^Qhh, Hh^Dr, Hh^Qhh, Cfr^Es, Cfr, Cfr, Gs^Efm, Gs^Fet, Mm^Qhh, Mm^Qhh
Wwg, Ds^Ewsh, 1 Ds^Ewsh, Ds, Ds, Ds, Chr, Chr, Chr, Mm, Mm, Hh^Fds, Gs^Es, Gll^Em, Hh^Fp, Mm, Mm, Wog, Wog, Wwg, Gll^Efm, Wwf, Gg, Hh, Hh, Mm, Mm^Xm, Mm^Xm, Mm^Xm, Mm^Xm, Mm^Qhh, Hh^Qhh, Hh^Fds, Gg^Fds, Gg^Fms, Gg, Gg^Fds, Hh^Fds, Mm^Qhh, Mm^Qhh
Wwf^Wkf, Wwf, Wwrg, Wwrg, Ds, Mm, Chr, Khr, Chr, Mm^Xm, Mm^Xm, Hh^Emf, Hh^Emf, Gs, Hh, Hh, Hh^Em, Hh, Wwg, Gd^Fp, Gll^Fp, Gll, Gs^Fds, Gs^Vc, Hh^Fds, Hh, Hh, Mm^Xm, Mm, Mm^Xm, Mm, Mm^Qhh, Hh^Fms, Gg^Fds, Hh^Fds, Hh^Dr, Mm^Qhh, Hh^Fds, Mm^Qhh, Mm^Xm
Wwf^Wkf, Wwrg, Wwrg, Ds, Mm, Mm, Mm^Xm, Chr, Mm^Xm, Mm, Mm, Hh^Dr, Mm, Mm, Mm, Hh, Mm, Mm, Wwf, Gd^Fp, Gll^Fp, Gs^Fms, Gs^Es, Gs^Es, Gs^Fds, Hh^Fds, Hh^Em, Mm, Hh, Hh^Dr, Mm, Mm^Qhh, Mm^Qhh, Hh^Fms, Mm^Qhh, Mm^Qhh, Mm^Xm, Mm^Qhh, Mm^Xm, Mm^Xm
Wwg, Wwf^Wkf, Wwrg, Ds, Mm, Mm, Mm^Xm, Mm^Xm, Mm^Xm, Mm, Mm, Mm, Mm, Mm, Mm, Mm, Mm, Mm, Wwf^Wkf, Wwf, Ds, Gd, Gs, Gs^Fds, Gs^Fds, Hh^Fds, Hh^Emf, Hh^Fds, Hh^Fds, Mm, Mm, Mm, Mm^Xm, Mm^Qhh, Mm, Mm, Mm^Xm, Mm^Xm, Mm^Xm, Mm^Xm
Wwg, Wwg, Wwg, Ds, Mm, Mm^Xm, Mm^Xm, Mm^Xm, Mm^Xm, Mm^Xm, Mm^Xm, Mm^Xm, Mm^Xm, Mm^Xm, Mm^Xm, Mm^Xm, Mm^Xm, Mm, Wwf, Wwf, Ds^Es, Ds, Gg^Efm, Gs^Fds, Hh, Hh^Em, Hh^Emf, Hh^Emf, Mm, Mm, Mm, Mm^Xm, Mm^Xm, Mm^Xm, Mm^Xm, Mm^Xm, Mm^Xm, Mm^Xm, Mm^Xm, Mm^Xm
Wwg, Wwg, Wwg, Ds, Mm, Mm^Xm, Mm^Xm, Mm^Xm, Mm^Xm, Mm^Xm, Mm^Xm, Mm^Xm, Mm^Xm, Mm^Xm, Mm^Xm, Mm^Xm, Mm^Xm, Mm, Wwf, Wwg, Gg, Gs^Efm, Gg, Gg, Hh, Hh, Hh, Hh^Dr, Mm, Mm, Mm, Mm^Xm, Mm^Xm, Mm^Xm, Mm^Xm, Mm^Xm, Mm^Xm, Mm^Xm, Mm^Xm, Mm^Xm
