Md^Qhh, Md^Qhh, Md^Qhh, Md^Qhh, Md^Qhh, Md^Qhh, Md^Qhh, Md^Qhh, Md, Md, Md, Md, Md, Md, Md, Md, Hhd^Fp, Gd^Fp, Gll^Fp, Gll^Fp, Re^Es, Gll^Fp, Gll^Fp, Gd^Fp, Hhd^Fp, Hhd^Fp, Md, Md, Md, Md, Md
Md^Qhh, Md^Qhh, Hhd^Fp, Md^Qhh, Gll^Efm, Md^Qhh, Md^Qhh, Md, Hhd^Em, Md, Hhd^Vo, Hhd^Fp, Hhd^Fp, Md, Hhd^Fp, Md, Gd^Fp, Gd^Fp, Gll^Fp, Gll^Fp, Re, Wwf, Gll^Fp, Gll^Fp, Hhd^Fp, Hhd^Fp, Hhd^Fp, Hhd^Fp, Hhd^Fp, Md, Md
Md^Qhh, Md^Qhh, Hhd^Emf, Gll^_mh, Md^Qhh, Md^Qhh, Md^Qhh, Md, Md, Hhd^Emf, Gd^Emf, Hhd^Em, Gd^Fp, Hhd^Fp, Wwf^Es, Hhd, Gd, Gll^Edb, Ce^Edb, Wwf^Es, Wwf, Re, Gd^Es, Gd, Gd, Gll^Em, Gll^Em, Gd^Fp, Hhd^Fp, Md, Md
Md^Qhh, Md^Qhh, Md^Qhh, Gd^Em, Hhd^Fp, Md^Qhh, Md^Qhh, Md, Hhd^Fp, Gd^Emf, Gll^Es, Gll^Em, Re, Wwf^Es, Wwf, Gd, Hhd^Edb, Ce^Edb, 1 Ke, Ce^Edb, Ce^Edb, Re^Es, Rb, Gd^Es, Re^Emf, Gll^Fp, Gd^Em, Hhd^Emf, Hhd, Md, Md
Md^Qhh, Md^Qhh, Md^Qhh, Hhd^Fp, Hhd^Fp, Hhd^Qhh, Hhd^Fp, Md, Hhd^Fp, Hhd^Fp, Gll^Es, Re^Em, Gd, Md, Md^Xm, Md^Xm, Md, Hhd^Ecf, Cfr^Emf, Cfr^Edb, Hhd^Edb, Gd^Vc, Gll^Fp, Rb^Em, Gll^Emf, Re^Emf, Gll^Em, Gd, Hhd^Fp, Hhd^Fp, Hhd^Fp
Md^Qhh, Md^Qhh, Md^Qhh, Md^Qhh, Md^Qhh, Hhd^Qhh, Hhd^Fp, Hhd^Fp, Hhd^Em, Gd^Fp, Rb, Re, Hhd, Md, Hhd^Vhr, Md^Xm, Md, Hhd^Em, Gll^Em, Hhd^Edb, Hhd, Gd^Fp, Gll^Fp, Gll^Fp, Gll^Fp, Gll^Fp, Rb, Gd^Efm, Gd^Efm, Gll^Fp, Gll^Fp
Md^Qhh, Md^Qhh, Md, Md, Md, Hhd, Gll, Gll^Fp, Gd^Fp, Gd, Rb^Es, Gd, Hhd^Em, Hhd^Emf, Hhd^Emf, Md, Hhd^Em, Gll^Em, Wwf^Es, Wwf, Hhd, Hhd^Fp, Gll^Fp, Gll^Fp, Gll, Gd^Efm, Gd^Vc, Rb^Es, Gll^Es, Gll^Fp, Hhd
Md^Xm, Md^Qhh, Md^Qhh, Hhd^Fp, Gll^Fp, Hhd^Fp, Gd^Es, Gll^Es, Gd, Gd^Efm, Gd^Es, Gd^Es, Gll^Em, Md, Md, Hhd, Hhd, Hhd^Emf, Gd^Em, Wwf, Wwf^Es, Hhd, Hhd^Fp, Hhd^Fp, Hhd^Fp, Gd, Gd^Em, Rb, Gll^Emf, Hhd, Hhd^Fp
Md^Xm, Md^Xm, Md^Qhh, Hhd^Qhh, Hhd^Fp, Gd^Fp, Gd, Hhd^Fp, Hhd^Fp, Hhd^Fp, Hhd^Fp, Gll^Fp, Hhd, Md, Md, Md, Hhd^Em, Gd, Wwg, Wwg, Hhd^Fp, Hhd, Hhd^Fp, Hhd^Fp, Hhd^Qhu, Hhd^Qhu, Wwf^Qhu, Gll, Md, Md, Md
Md^Qhh, Md^Qhh, Wwf^Qhh, Hhd^Qhh, Hhd^Qhu, Hhd^Em, Hhd^Qhu, Hhd^Qhu, Hhd^Qhu, Hhd^Fp, Hhd^Fp, Hhd^Qhuf, Md^Qhu, Md^Qhu, Md^Qhu, Hhd, Hhd, Wwf, Wwf^Es, Wwf, Hhd^Em, Hhd^Fp, Hhd, Hhd^Em, Wwrg^Qhu, Wwf^Es, Wwf^Qhu, Gll, Md, Md, Md
Md^Qhh, Hhd^Qhh, Wwg^Qhh, Wwg^Qhh, Wog^Qhux, Wwrg^Qhu, Wwf^_ml, Wwf^Es, Wwf^Qhu, Hhd^Fp, Wwg^Qhu, Wwf^Qhu, Wwf^Qhu, Wwf^Qhu, Wwf^Qhu, Hhd^Qhu, Gll^Fp, Gll^Es, Gll, Hhd, Wog^Qhu, Wog^Qhu, Wog^Qhu, Wwg^Qhu, Wog^Qhu, Wog^_mll, Wwg^Qhu, Hhd, Hhd, Md, Hhd
Md, Md, Hhd, Wwrg^Qhu, Wwg^Qhu, Wwrg^Qhu, Wwf^Qhu, Wwf^Qhu, Cfr^Eb, Wwrg^Qhu, Hhd^Fp, Hhd^Qhu, Cfr^Fp, Wwf^Qhu, Cfr^Em, Wwf^Qhu, Wwg^Qhu, Wwrg^Qhu, Wwrg^Qhu, Wwg^Qhu, Wog^Qhux, Wog^_mll, Wwg^Ewl, Wwg^Ewf, Wwg^Ewl, Wog^Qhu, Wwg^Qhu, Hhd^Qhu, Hhd^Qhu, Hhd^Qhu, Hhd
Md, Md, Md, Hhd, Md^Xm, Md^Xm, Md, Hhd^Qhu, Gd^Es, Gll^Fp, Gll^Fp, Hhd^Fp, Hhd^Fp, Hhd, Hhd^Emf, Cfr, Gd^Em, Wwrg^Qhu, Wog^Qhu, Hhd^Qhu, Wog^Qhu, Wog^Wkf, Wog^Wkf, Wwg^Ewl, Wog^Qhu, Wwg^Wkf, Rb^Es, Wwf^Qhu, Wwg^Qhu, Wwf^Qhu, Wwf^Qhu
Md^Xm, Md, Md^Xm, Md, Md^Xm, Md^Xm, Hhd^Em, Gll^Em, Gd, Gd^Efm, Gd^Fp, Gd^Fp, Hhd, Hhd^Vc, Md, Gd^Em, Gll^Fp, Wwg^Qhu, Wwrg^Qhu, Wwg^Qhu, Wog^Qhux, Wog^Wkf, Wog^_mll, Wog^Qhu, Wog^Wkf, Chw^Qhu, Khw^Qhu, Hhd^Qhu, Wog^Wkf, Wwf^Qhu, Wwg^Qhu
Md^Xm, Md^Xm, Md^Xm, Md^Xm, Md, Md^Xm, Md, Hhd^Em, Hhd, Hhd, Hhd, Gll^Fp, Md, Hhd^Fp, Hhd^Em, Hhd, Hhd^Fp, Gll^Fp, Gd, Wog^Qhux, Wog^_mll, Wog^Qhu, Wwg^Ewl, Wog^Wkf, Wwg^Wkf, Chw^Ewl, Wwf^Wkf, Wog^Wkf, Chw^Ewf, Wog^Qhu, Wwg^Qhu
Md^Xm, Md, Md, Hhd^Em, Md, Wwg, Wwg, Wwf^Es, Md, Md, Md^Xm, Hhd, Md^Xm, Md, Md, Hhd^Fp, Hhd^Fp, Gll^Fp, Gll^Fp, Wog^Qhu, Wog^Qhu, Wog^Wkf, Wwg^Ewf, Wwg^Ewf, Wwrg^Qhu, Wwg^Ewf, Wwf^Ewl, Wwg^Wkf, Wwg^Qhu, Wwrg^Qhu, Wwrg^Qhu
Md^Xm, Md^Xm, Md, Hhd, Wwf^Es, Wwg^Ewl, Wwg^Vm, Wwg^Wkf, Wwf^Wkf, Md, Md, Md^Xm, Md^Xm, Md, Md^Xm, Md, Hhd^Fp, Hhd^Vhr, Gll^Es, Gll^Es, Wwrg^Qhu, Wwrg^Qhu, Wwg^Qhu, Wwg^Wkf, Wwg^Ewl, Wwg^Ewf, Wwf^Wkf, Wwf^Qhu, Hhd, Wwrg^Qhu, Hhd
Md^Xm, Md^Xm, Md, Md, Hhd^Emf, Wwg^Wkf, Wwf, Wwg^Wkf, Wwf, Hhd, Md, Md^Xm, Md^Xm, Md^Xm, Md^Xm, Md, Md, Hhd^Em, Hhd, Gd^Efm, Gd^Efm, Wwrg^Qhu, Gd^Em, Wwg^Qhu, Wog^Wkf, Wwg^Ewl, Wog^Wkf, Hhd^Qhu, Hhd^Qhu, Hhd, Hhd^Fp
Hhd^Fp, Hhd^Fp, Hhd^Em, Hhd^Emf, Wwf^Es, Wwf^Es, Hhd^Emf, Hhd^Em, Hhd, Hhd, Md, Md^Xm, Md, Md^Xm, Md, Md, Md^Xm, Hhd^Fp, Gd^Fp, Gd^Fp, Gd, Gd^Es, Gd^Es, Wwrg^Qhu, Wwg^Qhu, Wog^Wkf, Wog^Qhu, Rb^Vhcr, Hhd^Qhu, Hhd, Hhd^Fp
Md, Hhd^Fp, Hhd, Hhd^Em, Hhd, Wwf^Es, Gd, Gll^Fp, Hhd, Md, Md, Md, Md, Hhd^Fp, Md, Md^Xm, Md^Xm, Md, Md, Gll^Fp, Gll^Fp, Gll, Hhd^Qhu, Rb^Qhu, Wwg^Qhu, Wog^Qhu, Wwrg^Qhu, Wwg^Qhu, Wwf^Qhu, Hhd^Fp, Gll^Fp
Md, Md, Hhd, Hhd, Gll^Efm, Wwg, Wwrg, Gd^Efm, Wwf, Md, Md, Hhd^Fp, Hhd^Fp, Hhd^Fp, Hhd^Fp, Md, Md, Hhd^Fp, Gll^Fp, Gll^Fp, Gll^Fp, Gll^Es, Gll^Es, Rb^Qhu, Wwrg^_mll, Wwrg^Qhu, Wwrg^Qhu, Gd, Gd^Es, Gll^Fp, Gll^Fp
Md, Md, Md, Md, Gd^Efm, Gd^Efm, Wwg^Wkf, Wwf^Wkf, Hhd, Hhd, Wwf, Hhd^Fp, Md, Md, Md, Hhd, Hhd, Hhd^Vo, Hhd^Fp, Gd^Fp, Gd^Es, Rb^Es, Gd, Wwf^Qhu, Wwf^Qhu, Wwf^Ewl, Wwf^Qhu, Gll^Efm, Gll^Fp, Gll^Emf, Gll^Fp
Md, Md, Md, Gll^Vhhr, Wwf, Wwf^Es, Wwf^Ewl, Wwf^Wkf, Wwf^Es, Hhd^Em, Wwf^Es, Wwf, Gd^Edb, Hhd, Hhd^Fp, Hhd, Hhd, Hhd^Em, Hhd^Fp, Gd^Fp, Rb, Rb^Es, Hhd, Gd^Efm, Wwf^Qhu, Wwf^Qhu, Gll^Efm, Gll^Efm, Hhd, Gll^Fp, Hhd^Fp
Hhd^Em, Hhd^Em, Hhd^Fp, Gll, Gd^Em, Wwf^Wkf, Wwf, Wwf^Es, Wwf^Es, Wwf, Cfr^Fp, Ce^Edb, Ce^Edb, Gd, Re^Edb, Gd^Vc, Rb^Em, Hhd, Rb, Gd^Es, Md, Hhd, Md^Qhu, Wwf^Qhu, Wwf^Qhu, Hhd, Md, Hhd^Fp, Md, Hhd^Fp, Hhd^Fp
Wwf^Es, Hhd, Wwf^Es, Gd, Wwrg, Wwrg, Hhd, Hhd^Fp, Wwf^Ewl, Wwf^Ewl, Cfr^Fp, 2 Kfr, Cfr^Emf, Gll^Ecf, Gll^Edb, Rb^Edb, Hhd^Fp, Rb^Es, Hhd, Md, Md^Qhu, Md^Qhu, Md^Qhu, Wwrg^Qhu, Wwg^Qhu, Hhd^Vc, Hhd, Hhd, Md, Md^Xm, Md^Xm
Wwf, Wwf, Hhd, Wwg, Hhd, Wwrg, Gll, Hhd^Fp, Hhd^Em, Hhd^Fp, Hhd^Fp, Cfr, Hhd, Gll^Edb, Re^Edb, Rb^Es, Hhd^Fp, Hhd^Fp, Md, Md, Md^Qhu, Wwrg^Qhu, Wwrg^Qhu, Wwg^Qhu, Wog^Wkf, Wwg^Qhu, Wwf^Qhu, Wwf^Qhu, Hhd, Md^Xm, Md^Xm
Md, Md, Md^Xm, Md, Md, Hhd^Fp, Gll^Fp, Hhd, Hhd^Fp, Hhd^Emf, Hhd^Emf, Hhd^Edb, Gd^Emf, Gd^Edb, Re, Hhd, Md, Md, Md, Md^Qhu, Hhd^Qhu, Wwrg^Qhu, Wwg^Wkf, Wog^_mll, Wog^Ewl, Wwg^Wkf, Wwrg^Qhu, Wwf^Qhu, Md^Qhu, Md, Md^Xm
Md, Md^Xm, Md^Xm, Md^Xm, Md, Hhd^Fp, Gll^Fp, Gll^Fp, Hhd^Fp, Hhd^Emf, Hhd^Fp, Hhd, Gll, Re^Em, Hhd, Md, Md, Md, Md, Md^Qhu, Hhd^Qhu, Hhd^Qhu, Wog^Qhu, Wog^Ewl, Wog^Ewl, Wog^Qhu, Wwrg^Qhu, Md^Qhu, Md^Qhu, Md^Xm, Md^Xm
