Md, Gd, Gs^Efm, Gs, Gd, Gd, Re, Gs, Gs, Gs, Gg, Hhd, Hhd, Hhd, Md, Md, Md, Hhd, Hhd, Hhd, Gd, Gd, Gd^Edt, Gd^Fp, Wwrg, Wwg, Wwg, Gd^Fp, Gd, Gs, Gs^Fms, Md, Md, Md, Md, Hh, Hh, Gd, Md, Md
Md, Re, Md, Gd^Efm, Md^Xm, Hh, Md, Gd, Re, Ds, Gd, Gs^Efm, Gs, Hhd, Hhd^Emf, Md, Md, Md, Md, Md, Gg, Gd, Gd, Gd^Fp, Ds, Wog, Gd^Fp, Gd^Fp, Ds, Gd, Gs^Fms, Hh^Emf, Hh^Em, Hh, Md^Xm, Hh, Md, Hhd^Em, Hhd^Em, Md
Md, Md, Md^Xm, Gd^Efm, Gll^Fmw, Md, Hhd, Hhd, Gd^Vhr, Gd^Edt, Gll^Fmw, Gd, Gd, Hh^Em, Hh, Md, Hh^Em, Hh^Em, Hh^Em, Md, Hh, Md, Hhd^Vhhr, Gs, Md, Wwf, Gd, Gd^Edt, Ds, Hhd^Fms, Gd, Gs^Fms, Gs^Fms, Md, Md, Md, Gd, Md, Gd, Hhd
Hhd, Md, Md, Md^Xm, Hhd^Fmw, Hhd, Ce^Edt, Hhd^Fms, Hhd^Fms, Hhd^Fds, Hhd, Hhd, Gd^Em, Gd, Gd, Hh^Em, Gs^Efm, Md^Xm, Md, Md, Md, Hhd^Dr, Wwg, Hhd, Ww, Ww, Gs, Wwrg, Wwf, Ds, Gd, Gs, Gd, Md, Gd, Gd^Edt, Gg, Gd^Es, Gd^Edt, Gd
Hhd, Hhd^Fms, Md, Md, Hhd^Dr, Co, 1 Ke, Ce^Edt, Co^Edt, Hh, Re^Edt, Hhd^Fms, Gd, Gs^Edt, Gd^Vhr, Gs^Efm, Gs, Md, Md, Gd^Fp, Gd^Fp, Md, Md, Hhd, Md, Gd^Fp, Ww^Wkf, Wwf, Ds, Ds, Gs, Co^Edt, Re^Edt, Gd^Edt, Gd, Gs^Fms, Gd^Es, Gd^Es, Gd^Edt, Gd^Edt
Ww^Wkf, Hhd, Hhd, Hhd^Emf, Gs, Ce^Edt, Gs^Fms, Co^Edt, Gs, Re^Edt, Gs^Fms, Gd, Gd^Efm, Gg^Edt, Rb, Rb, Rb, Gs^Fp, Gd^Fp, Gd^Fp, Md, Gd^Fp, Ww^Ewf, Wwg, Wwg, Wog, Wwf, Wwf^Wkf, Rb, Gs, Co, Co^Edt, 2 Ko, Co^Edt, Gd^Edt, Gd, Gd, Gs, Gs, Hh
Wwf, Ww^Wkf, Wwg, Hhd, Md, Re, Gg, Re^Edt, Gs^Fms, Re^Edt, Re, Gg^Fet, Gs^Fds, Gd^Edt, Gd^Edt, Gs^Es, Re, Md, Re, Md, Md, Md, Md, Hhd, Wwf, Wog, Wwrg, Wwf, Rb, Gs^Edt, Co^Edt, Co^Edt, Co, Rr, Gd^Ecf, Gs, Md^Xm, Md, Hh, Hh
Gd, Wwf, Wwf, Hhd^Em, Hhd^Fds, Ds, Re, Re, Re, Ds, Ds, Wwf, Wwf, Gs^Fds, Rb, Gd, Gll, Re, Ds, Gd, Gd, Gll, Gd^Dr, Hhd, Wwf, Wog, Wog, Wog, Gg, Gs^Edt, Gd^Edt, Rr, Rr, Rr, Gs, Gs, Md, Md, Hh, Md
Gd, Ds, Wwf^Wkf, Wwg, Wwrg, Wwf^Wkf, Wwg, Re, Wwg, Wwg, Wog, Ds, Ww^Wkf, Wwf, Ww^Wkf, Re, Gd^Fp, Gd^Fp, Wwrg, Ds, Ds, Gll, Gll, Wwf, Gll, Md, Gll, Wwg, Gg, Gd, Gg, Gd^Vo, Hhd^Fms, Hhd^Fms, Hhd^Fms, Md, Gd, Hh^Fp, Md, Md
Ds, Wwf, Wwg, Wog, Ds, Wwrg, Wwf, Wwf, Re, Wog, Ds^Es, Ds^Es, Ww^Wkf, Wwf, Wwf, Wwf, Wwg, Wwg, Wwf^Wkf, Ww, Ds, Wwf, Wwf, Gll, Gs^Es, Gll, Gd, Gg, Gd^Edt, Gg^Edt, Gd^Edt, Gd, Gd, Md, Hhd^Em, Gd, Md, Hh^Fp, Hh^Fp, Md
Hh, Ds, Ds^Es, Ds, Gs^Es, Re, Wwf, Re, Rb, Gll, Ds^Es, Wwg, Ds, Ds, Ds, Ds, Md, Md^Xm, Wwg, Wwrg, Wwrg, Wog, Wwg, Wwf, Ds, Gs, Gd, Gd, Gd^Edt, Gd^Edt, Gd, Gd, Hhd^Fp, Hhd^Emf, Hh^Emf, Md, Md, Md, Hh, Md
Gd^Qhu, Hh, Gd, Gs^Es, Md, Re, Re, Wog, Re, Gd, Gd^Edt, Ds, Gd^Edt, Md, Md, Md, Gd^Fp, Md, Wwf, Wwf, Ds, Wwg, Re, Wwf, Gd, Gd, Gd^Edt, Gd^Efm, Gs^Efm, Gd, Rb, Md, Hhd^Fp, Gd, Md, Md, Gd^Fp, Gs^Fp, Hh, Md
Gd^Qhu, Hh, Hh, Gd, Gd, Re^Edt, Gs, Md, Hh, Hhd^Emf, Hhd^Emf, Gd, Gd, Gs^Fds, Gs^Fds, Gd^Fp, Hhd, Md, Md, Ww^Ewf, Ds, Re, Re, Gd^Efm, Gd^Fp, Gd, Md, Gd^Vo, Gs, Hhd^Em, Gd, Rb, Hhd^Fp, Gd, Gd, Hh, Gd^Fp, Md, Md, Md
Hhd^Qhu, Gd^Qhu, Hh, Gd^Efm, Gg, Gs, Hhd^Fds, Md, Md, Md, Hhd^Dr, Gll, Gd, Gd, Gll, Gs, Gs, Ds, Ds, Ds, Wwf, Wwf, Wwf, Gs, Gs^Efm, Gd^Efm, Gd, Md, Md, Hhd^Emf, Gll, Gd, Gd, Gll^Efm, Gd, Gd, Md, Gd^Fp, Md, Md
Hhd^Qhu, Gd^Qhu, Gd^Qhu, Hhd^Fds, Gg^Fet, Gs, Md, Md, Hhd^Vhhr, Md, Md, Md, Gd, Gd^Edt, Gg, Gll, Gs, Gs, Gs^Fds, Ww, Wwrg, Wwrg, Md, Wog, Wog, Gs^Efm, Gd, Hhd^Fp, Md, Hhd^Fp, Gll, Gd, Gd^Efm, Gd, Gd, Hhd, Hhd^Fp, Md, Hhd, Md
Hhd^Qhu, Md^Qhu, Gd^Qhu, Hhd, Hhd, Gd, Gd, Md, Gd, Gs^Efm, Gs^Efm, Gs^Efm, Gd^Edt, Gd^Edt, Hhd^Em, Gll, Md, Md, Gs^Vl, Gs^Fds, Gd, Gs, Wog, Wog, Ds, Gs^Efm, Gd^Es, Gd, Md, Hhd^Vhhr, Gll^Feth, Md, Md, Gd^Efm, Gg, Gd, Gd, Hhd^Fp, Gg, Hhd
Hhd^Qhu, Hhd^Qhu, Hhd^Qhu, Gd^Qhu, Gd^Qhu, Hhd, Gs, Gd^Edt, Gd^Edt, Gd, Gd, Gd, Gs, Hhd^Emf, Hhd, Gs^Fds, Hhd, Md, Gd, Gd, Gs, Gd, Wog, Wwf, Ds, Gll^Fp, Gll^Fp, Gd, Gd^Efm, Gd, Gd^Edt, Gll, Md, Gs^Efm, Hh, Gg, Gs^Efm, Gd, Gd, Gg
Hhd^Qhu, Hhd^Qhuf, Hhd^Qhu, Md^Qhu, Gd^Qhu, Hhd, Md, Md^Xm, Md, Gs, Gd^Qhu, Gd, Gs, Gll, Hhd^Em, Hhd^Em, Md, Md, Gg, Gs^Efm, Wwg, Gs, Wog, Ds, Wog, Wog, Gll^Fp, Gd, Gd, Gd^Efm, Gs, Md, Md, Hh^Em, Md, Hh, Gd, Gs^Es, Gd, Gg
Hhd^Qhu, Hhd^Qhuf, Md^Qhu, Md^Qhu, Hh, Gd^Qhu, Gd^Qhu, Md, Gd^Qhu, Gd^Qhu, Gs^Qhu, Gs^Qhu, Hhd^Qhh, Gs, Gd, Gg, Gd, Gd, Gg, Gs, Ds, Ds, Wog, Wog, Ww, Gll^Fp, Gd, Re, Gd, Gd^Es, Gs, Md, Hh, Md, Gd^Efm, Md, Re, Gd, Re, Gg
Hhd^Qhu, Hhd^Qhuf, Hhd^_ml, Hh^Fms, Md, Hh^Fms, Hhd^Qhuf, Gd^Qhu, Wwf^Qhu, Wwf^Qhu, Wwf^Qhu, Hhd^Qhh, Hhd^Qhh, Gd, Gd, Gd, Gll, Gd, Gg, Ds, Ds, Wog, Wwf, Wog, Ww^Wkf, Re, Wwrg, Gs, Ds, Gd, Gs^Vht, Gs^Efm, Gd, Gd^Efm, Ds, Gd, Wwg, Re, Wwf, Re
Hh^Qhu, Hhd^Qhuf, Hhd^Fms, Hh, Hhd^Qhuf, Hhd^Qhuf, Hhd^Qhuf, Hhd^Qhuf, Wwf^Qhu, Gd^Qhuf, Gs^Qhu, Wwf^Qhu, Hhd^Qhh, Hhd^Qhh, Hhd^Qhh, Hhd^Qhh, Gd^Fp, Gd, Md, Gg, Ds, Wwg, Wwf, Ww, Re, Re, Wwrg, Rd, Ds, Gs^Es, Gd^Es, Gd^Es, Wwrg, Gs, Wwg, Wwg, Wwg, Wwf, Wwf, Re
Hh^Qhu, Hhd^Qhuf, Hhd^Qhuf, Hhd^Qhuf, Hhd^Qhuf, Hhd^Qhuf, Hhd^Qhu, Hhd^Qhu, Gd^Qhu, Gd^Qhu, Gs^Qhuf, Gd^Qhu, Gd^Qhu, Md^Qhh, Md^_mh, Md^Qhh, Hhd^Qhh, Gd, Gs^Efm, Gd, Gd, Wwf, Re, Wwf, Ww^Wkf, Ww, Ww, Ds, Re, Ds, Ds, Ds, Wwg, Wog, Wwf, Ds, Wog, Wwrg, Wog, Wwf
Hhd^Qhu, Hh^Qhu, Hhd^Qhu, Hhd^Qhuf, Hhd^Qhu, Hhd^Qhu, Gs^Qhu, Hhd^Qhuf, Gs^Qhu, Gs^Qhuf, Gs^Qhuf, Gs^Qhuf, Gs^Qhuf, Hhd^Qhh, Md^Qhh, Md^Qhh, Md^Qhh, Hh^Qhh, Gs^Efm, Gd, Gs, Re, Re, Ww^Wkf, Md, Ds, Ww, Wwf, Re, Ds, Wwg, Wwg, Rd, Wwf, Wwg, Ds, Ds, Wwg, Ds, Wwg
Hh^Qhu, Hh^Qhu, Hhd^Qhu, Hhd^Qhu, Hhd^Qhuf, Wwf^Qhu, Wwf^Qhu, Gd^Qhu, Gs^Qhuf, Gs^Qhu, Hh^Fds, Gs^Qhuf, Md^Qhh, Md^Qhh, Hh, Md^Qhh, Md^Qhh, Hh^Qhh, Md^Qhh, Gs^Efm, Re, Re, Gd^Efm, Md, Ds, Ds, Wwf, Wwf^Ewf, Re, Md, Gd, Gd, Gs, Wwf, Gd^Fp, Re, Re, Ds, Ds, Gd
Md^Qhh, Hh^Qhuf, Hhd^Qhu, Hhd^Qhuf, Hhd^Qhuf, Md^Qhh, Wwf^Qhu, Gs^Qhuf, Md^Qhh, Gs^Qhuf, Hhd^Fds, Hh, Hh, Hh, Md, Gs^Fms, Md^Qhh, Hh^Qhh, Hh^Qhh, Gs^Efm, Re, Gd^Efm, Wwf, Ds, Wwg, Wwg, Re, Re, Gd, Gs, Gs^Es, Gs^Es, Gs^Es, Gd, Gd^Fp, Md, Re, Re, Gd, Gd
Hhd^Qhh, Md^Qhh, Md^Qhh, Md^Qhh, Md^_mh, Md^Qhh, Md^Qhh, Md^Qhh, Md^Qhh, Hhd^Qhh, Hhd, Md, Hhd, Hhd, Gs^Fms, Gs^Fms, Md^Qhh, Hh^Qhh, Gd, Gd^Efm, Re^Edt, Re, Wwg, Wog, Wwg, Md, Gs, Rp^Vhcr, Gd^Efm, Md, Md, Md, Md, Md, Gd^Fds, Md, Hh^Em, Re, Md, Gd
Md^Qhh, Hhd^Qhh, Md^Qhh, Md^Qhh, Md^Qhh, Md^Qhh, Md^Qhh, Md^Qhh, Md^Qhh, Hhd^Qhh, Hhd^Fp, Md, Md, Hh, Gd, Gd, Gd^Fds, Gd, Hh, Gd, Re^Edt, Wwg, Re^Edt, Wwg, Wwf, Wwf, Wwf, Gs, Gd^Efm, Md, Md, Rb, Rb, Rr, Rr, Rr, Rr, Hh, Hh, Gd
Md^Qhh, Hhd^Qhh, Md^Qhh, Md^Xm, Hhd^Qhh, Md^Qhh, Md^Qhh, Hh^Qhh, Hhd^Qhh, Md^Qhh, Re, Re, Re, Md, Hh, Gd, Md, Md, Hh, Hh, Re, Rp^Vhcr, Gd^Edt, Re^Edt, Re, Ww, Wog, Gs^Efm, Re, Gd^Fp, Gd^Fp, Gd^Fp, Rb, Gd^Edt, Co^Edt, Co, 3 Ko, Co^Edt, Hh^Dr, Gd
Md^Qhh, Md^Qhh, Wwg, Wwrg, Hhd^Qhh, Md^Qhh, Hh^Qhh, Hh^Qhh, Hh^Qhh, Re, Md^Xm, Gd^Vo, Md, Md, Md, Md, Md, Hh, Md, Md, Md, Gd, Hh, Gd, Md, Gd, Ww, Ww, Gs^Fms, Gs, Gd, Gd, Gd^Ecf, Gd, Rr^Edt, Co^Edt, Co, Co^Edt, Md, Gd
Md^Qhh, Md^Qhh, Md^Qhh, Wog, Hhd^Qhh, Hhd^Qhh, Re, Re, Re, Re, Gs, Gd, Md, Md, Gd^Fp, Gs^Fms, Md^Xm, Md, Hhd, Md, Md, Md, Hh, Hh, Md, Gd, Gd, Re, Gs^Fms, Gs^Es, Gs, Gd, Gd, Gd, Gd^Edt, Md, Gd, Gd^Edt, Gd, Gd
Wwf, Wwf, Wwf^Ewf, Wwg, Wwg, Wwf, Gs, Gll, Gd, Gs, Md, Gd, Gd, Gll, Gll, Gg, Md, Gll^Fetd, Gll, Hhd, Md, Hh, Gd^Es, Md, Md^Xm, Gd^Efm, Md, Md, Md, Gs^Fms, Gg, Md, Gd^Es, Gd^Edt, Gd^Fms, Gd^Fms, Gs, Gd^Vo, Gd^Es, Gs
Md, Md, Gd, Gd^Fts, Gs, Gs, Gd, Gd^Fp, Gs, Md^Xm, Md, Gd^Fp, Gd^Fds, Gd, Gg, Gll, Gll, Gll, Gd^Fp, Gd^Fp, Md, Gd, Gd^Es, Md, Gd^Fts, Md, Md, Gd^Fp, Gs, Gs, Gs^Es, Gs^Es, Gs^Fms, Gs^Es, Gs^Fms, Re, Re, Gd, Gs, Gs
Gs, Md, Gd, Gs, Gg^Edt, Gg, Gd^Ecf, Gs, Gd^Es, Md, Re, Rr^Fp, Gd^Efm, Gg, Md, Gg, Gg, Gd, Gd^Fp, Md, Md, Gd, Gd, Gd, Gd^Edt, Md, Md, Gd, Gd, Gs, Gd, Gd, Gd, Gd, Gd^Fms, Md, Re, Re, Gs^Fms, Gs
Gd, Gs, Gd^Edt, Gg, Co^Edt, Gd, Gd, Gd, Gs, Gs^Efm, Re, Rr, Gs, Gd^Efm, Gd^Es, Gd, Gd^Edt, Md, Gd^Fds, Md, Gg, Hh, Hh, Gd^Efm, Gd^Efm, Gd^Efm, Gd, Gd, Gd, Hhd^Em, Gd, Gs, Gs, Gs, Ds, Gd, Md, Gd^Fms, Hhd^Em, Hhd
Gs^Fms, Gd, Gs^Efm, Gs^Fms, Co, Rr, Co^Edt, Gd^Edt, Gd, Gs^Efm, Gs^Efm, Re, Gd^Fts, Gd, Gd^Fp, Gd^Efm, Gd^Edt, Gd^Fp, Hh, Hh^Em, Gg, Hh^Em, Gs, Gd, Gd, Gd^Vhr, Gs, Gd^Edt, Hhd, Hhd, Hhd^Em, Gs^Fms, Gd^Es, Gd, Gs, Ds, Ds, Md, Md, Hhd
Gd, Gd, Gs^Fms, Gs^Fms, Co, 4 Ko, Re, Gd^Edt, Gd^Vo, Ds, Ds, Gg, Md, Gs^Fds, Hh, Gd, Gd, Gd, Hh, Gs, Gs, Gs, Hh, Hh, Gd, Gs, Hhd^Em, Gs^Fms, Hhd, Md, Hhd^Vhhr, Gs^Fms, Gs^Fms, Gd, Gs, Gd^Edt, Gd, Ds, Md, Md
Gd, Gs^Edt, Md, Md, Co, Co, Md, Re, Hh, Gd^Fts, Ds, Gs, Md, Md, Hh, Gd, Gs, Gd^Edt, Gd^Edt, Gd^Es, Gd^Edt, Gs, Hh, Gd, Hhd, Hhd^Em, Md, Md, Hhd^Dr, Md, Md, Hhd, Hhd^Em, Md, Md, Gd, Gd, Ds, Md, Md
Gd^Edt, Gd^Edt, Md, Md^Xm, Md, Md, Hhd, Md, Hhd, Gd, Ds, Ds, Hh, Hh^Fp, Md, Gd^Fetd, Gg, Gd, Gd, Gd, Gs, Gd, Gd^Efm, Gd^Efm, Hhd, Md, Md, Hh, Md, Md, Md, Hh, Hh^Em, Hh^Em, Hh^Em, Md, Gd, Hhd, Hhd^Em, Hhd^Em
Gs^Fms, Gd, Gd, Md, Gg, Hhd, Gd^Es, Hhd, Gd, Gd, Md, Hh, Md, Md, Md, Hh, Md, Md, Md, Re, Gd^Edt, Gs, Gd, Gd^Efm, Gd^Efm, Gd^Efm, Gd^Efm, Hh, Md, Md, Md, Md, Md, Md, Md, Md, Gd, Gd^Edt, Gd^Edt, Gs
Gs^Fms, Gg^Fet, Gs^Fms, Gd, Gd, Gd, Md, Md, Md, Gs, Md, Md, Md, Md, Md, Md, Md, Md, Gd, Re, Re, Gs, Gs, Md, Gd, Gd, Gd, Hh, Md, Md, Md, Md, Md, Md, Md, Md, Gd, Gd^Edt, Gs, Gs
